. . . . . . . . . . . . . . . . . . . . . . . . . . . . . . . . . . 
. . . . . . . . . . . . . . . . . . . . . . . . . . . . . . . . . . 
. . . . . . . . . . . . . . . . . . # # # # # # # # # # # # # # # # 
. . . . . . . . . . . . . . . . . . # . . . . . . . . . . . . . # . 
. . . . . . . . . . . . . . . . . . # . . . . . . . . . . . . . # G 
. . . . . . . . . . . . . . . . . # # . . . . . . . . . . # # # # . 
. . . . . . . . . . . . . . . . # # . . . . . . . . . . { . . . . . 
. . . . . . . . . . K # # # # # . . . . . . . . . . . . # . . . # . 
. . . . . . . . . . / . . . . . . . . . . . . . . . . . K # # # # / 
. . . . . . . . . . / . . . . . . . . . . . . . . . . . . . . . . . 
. . . . . . . . . . / . . . . . . . . . . . . . . . . . . . . . # . 
. . . . . . . . . . # . . . . . . . . . . . # # # # # # / # # # # # 
. . . . . . . . . . # . . . . . # # # # # # . . . . . . . . . . . . 
. . . . . . . . . . # . . . # # . . . . . . . . . . . . . . . . . . 
. . . . . . . . . . . # . . # . . . . . . . . . . . . . . . . . . . 
. . . . . . . . . . . # # # # . . . . . . . . . . . . . . . . . . . 
. . . . . . . . . . . . . . . . . . . . . . . . . . . . / # . . . . 
. . . . . . . . . . . . . . . . . . . . . . . . . . # # / / . . . . 
. . . . . . . . . . . . . . . # # # # # # # # # # # # . . / . . . . 
. . . . . . . . . . . . . . . # . . . . . . . . . . . . . # # # # # 
. . . . . . . . . . . . # # # # . . . . . . . . . . . . # . . . . . 
. . . . . . . . . . . . . # . . . . . . . . . . . . . # . . . . . . 
. . . . . . . . . . . . . . # # # # # # # # # # # # # . . . . . . . 
. . . . . . . . . . . . . . . . . . . . . . . . . . . . . . . . . . 
. . . . . . . . . . . . . . . . . . . . . . . . . . . . . . . . . . 
. . . . . . . . . . . . . . . . . . . . . . . . . . . . . . . . . . 
. . . . . . . . . . . . . . . . . . . . . . . . . . . . . . . . . . 
. . . . . . . . . . . . . . . . . . . . . . . . . . . . . . . . . . 
