. . . . . . . . . . . . . . . . . . . . . . . . . . . # # . . . . . . . . . . . # P . . . . . . . . . . . . 
. . . . # # # . . . . . . . . . . . . . . . . . . . # . . . . . . . . . . . . . # . . . . . . . . . . . . . 
. . . . # . # . . . . . . . . . . . . . . . . . . # . . . . . . . . . . . . . . # . . . . . . . . . . . . . 
# # # # # . . # . . . . . . . . . . . . . . . . # . . . . . . . . . . . . . . . # . . . . . . . . . . . . . 
# P P ~ / . . . # . . . . . . . . . . . . . . . # . . . . . . . . . . . . . . . # . . . . . . . . . . . . . 
# # # # # . . . . # . . . . . . . . . . . . . . . . . . . . . . . . . . . . . . # . . . . . . . . . . . . . 
. . . . # . . . . . # # # # # . . . . . . . . . . . . . . . . . . . . . . . . . # / / / # . . . . . . . . . 
. . . . # . . . . . . . . . . . . . . . . . . # . . . . # . . . . . . . . . . . # # / # # . . . . . . . . . 
. . . . # # . . . . . . . . . . . . . . . . . . . . . . . # # # # # # # # # # # # . . . # . . . . . . . . . 
. . . . . # . . . . # . # # . . . . . . . . . . . . . . . . . . . . . # . . . . . . . # # . . . . . . . . . 
. . . . . # . . . . # . # . # # . . . . . . . # # . . . # . . . . . . . . . . . . . # . # . . . . . . . . . 
. . . . . # . # # . # . # . . . . . . . . . . . # # # # # # # # # # # # # # # . . . . . # . . . . . . . . . 
. . . . # . . . # . # / # # . . . . . . . . . . . . . . . . . . . . . . . . # # # . # . # . . . . . . . . . 
. . . . # . . . # . . . . # . . . . . . . . . . . . . . . . . . . . . . . . # . . . . # # . . . . . . . . . 
. . . . # . . . # . . . . # . . . . . . . . . . . . . . . . . . . . . . . . # # # # / # # # # . . . . . . . 
. . . . # . . . # . . . . / . . . . . . . . . . . . . . . . . . . . . . . . # . . . . . ~ ~ ~ . . . . . . . 
. . . . # . . . # # / / / # . . . . . . . . . . . . . . . . . . . . . . . . # . . . . . . . # . . . . . . . 
. . . . # . . . . # . . . . # . . . . . . . . . . . . . . . . . . . . . . . # . . . . # . . # . . . . . . . 
. . . . # . . . . # . . . . . # # # # # # # # # # . . . . . . . . . . . . . # # # # . # # # # . . . . . . . 
. . . . # . . . . # . . . . . # . . . . . . . . # . . . . . . . . . . . . . . . . # . { . . # . . . . . . . 
. . . . # . . . . # . . . . . # . # # . . . . . # . . . . . . . . . . . . . . . # # # # . . # . . . . . . . 
. . . . . # . . . # . . . . . # . . # . . . . . # . . . . . . . . . . . . . . . # . . . . # # . . . . . . . 
. . . . . # . . . # . . . . . / . . # . . . . . # # # # # # # # # # # # # # # # . . . . # . . . . . . . . . 
. . . . . # . . . # . . . . . # . . # . . . . . . { . . . . . . . . . . . . . # . . . . # . . . . . . . . . 
. . . . . # . . . # . . . . . # . . . . . . . . . { . . . . . . . . . . . . . / . . . # . . . . . . . . . . 
. . . . # ~ ~ . . # / # # # # # . . . . . . . . . { . . . . . . . . . . . . . / / . # . . . . . . . . . . . 
. . . . . . . # # # . . . . . # # # # # # # # # # # . . . . . . . . . . . . . / / . # . . . . . . . . . . . 
. . . . . . . . . . . . . . . . . . . . . . . . / / . . . . . . . . . . . . . / G # . . . . . . . . . . . . 
