. . . . . . . . . . . . . # . . . . . . # . . . . . . # . . . . . . . . # . . . . . . . . . . . . . . . . . . . . . . . . . . . . . . .
. . . . . . . . . . . . . { . . . . # . . . . . . . . . . # . . . # . . . . . . . . . . . . . . . . . . . . . . . . . . . . . . . . . .
. . . . . . . . . . . . . # # # # # # # # # # # # # # # # # # # # # # # # # # . . . . . . . . . . . . . . . . . . . . . . . . . . . . .
. . . . . . . . . . . . # . . . . . . . . . . . . . . . . . . . . . . . . # # # # # # . . . . . . . . . . . . . . . . . . . . . . . . .
. . . . . . . . . . . # . . . . . . . . . . . . . . . . . . . . . . . # # # # . . . . . . . . . . . . . . . . . . . . . . . . . . . . .
. . . . . . . . . . # . . . . . . . . . . . . . . . . . . . . . . . . . . . . # # # # # # # # / / / / # # # # # # # # # # # # # . . . .
. . . . . . . . . # . . . . . . . . . . . . . . . . . . . . . . . . . . . . . . . # # # # . . . . . . . . . . . . . . . . . . . . . . .
. . . . . . # # # . . # # # . . . . . # # # . . . . # . . . . . # . . # # # # . . . # # . . . . . . . . . . . . . . . . . . . . . . . .
. . # # . # . . . . # # # # # . . . # # # # / . . . # # . . . # # . . # . . . # . . # . . . . . . . . . . . . . . . . . . . . . # . . .
. # . . . . . . . # # . . . . . . # # . . . / # . . # . # . # . # . . # . . . # . . # . . . . . . . . . . . . . . . . . . . . . # . . .
. . . . . . . . . # # . . . . . . # # . . . # # . . # . # # # . # . . # # # / . . . # . . . . . . . . . . . . . . . . . . . . . # . . .
. . . . . . . . . # # . . . . . . # # . . . # # . . # . . # . . # . . # . . . . . # # # # # # # # # # # # # # # # # # # # # # # # # . .
# # # . . . . . . . # # # # # . . . # # # # # . . . # . . . . . # . . # . . . . . { { { / / / / . . . . . . . . . . . . . . . . G # . .
. . # . . . . . . . . # # # . . . . . # # # . . . . # . . . . . # . . # . . . . . # # # # # # # # = # # # # # = = # # # # # # # # # . .
. . . # . . . . . . . . . . . . . . . . . . . . . . . . . . . . . . . . . . . . . . . . . . . . # . . # . . . . . . . . . . . . . # . .
. . . # . . . . . . . . . . . . . . . . . . . . . . . . . . . . . . . . . . . . . . . . . . . . # . . . # . . . . . . . . . . . . # . .
. . . # . . . . . . # # # . . . . . . # # . . . . . . . # # . . . . . . # # # . . . . . . . . . # . . . . # . . . . . . . . . . . # . .
. . . # . . . . . # . . . # . . . . # . # . . . . . . # . # . . . . . # . . . # . . . . . . . . # . . . . . # . . . . . . . . . . / . .
. . # # . . . . . . . . # . . . . . . . # . . . . . . . . # . . . . . . . . # . . . . . . . . . # . . . . . . # . . . . . . . . . / . .
. . . # . . . . . . . # . . . . . . . . # . . . . . . . . # . . . . . . # # . . . . . . . . . . # . . . . . . . # # . . . . # . / . . .
. . . . # . . . . . # . . . . . . . . . # . . . . . . . . # . . . . . . . . # . . . . . . . . # . . . . . . . . . . # . # # . # # . . .
. . . . . . . . . # . . . . . . . . . . # . . . . . . . . # . . . . . . . . . # . . . . . . # . . . . . . . . . . . . # . . . . . . . .
. . # # # . . . . # # # # # . . . . # # # # . . . . . # # # # . . . . # # # # . . . . . . # . . . . . . . . . . . . . # . . . . . . . .
# # # # # # # . . . . . . . . . . . . . . . . . . . . . . . . . . . . . . . . . . . . . . # . . . . . . . . . . . . . # . . . . . . . .
# . . . . . . . . . . . . . . . . . . . . . . . . . . . . . . . . . . . . . . . . . . . . # . . . . . . . . . . . # # . # . . . . . . .
# . . . . . . . . . . . . . . . . . . . . . . . . . . . . . . . . . . . . . . . . . . . . # . . . . . . . . . . . # . . . # . . . . . .
# . . . . . . . . . . . . . . . . . . . . . . . . . . . . . . . . . . . . . . . . . . . . # . . . . . . . . . . . . . . . . # . . . . .
# . . . . . . . . . . . . . . . . . . . . . . . . . . . . . . . . . . . . . . . . . . . . # # . . . . . . . . . . . . . . . . . . . . .
